####..+.....~~~~
#<.+..$@...2..$$
####..$$$#####$$
@......~~~......
........~.......
@............~~~
~~..........~###
$..1.......~~#>#
~...........~#.#
.............#.#
@.......~~...+.#
##~~...~~~~#####
