####..+.....~~~~
#<.+..$@...3..$$
####..$$$##/##$$
@......~~~......
........7....2..
@.....4..6...~~~
~~....5.....~###
$..1.......~~#>#
~...........~#.#
.............#.#
@.......~~...+.#
##~~...~~~~#####
